9 9 9 9 9 9 9 9 9 9 9 9 9 9 9 9 9 9 9 9
9 9 9 9 9 9 9 9 9 9 9 9 9 9 9 9 9 9 9 9
9 9 9 9 9 9 9 9 9 9 9 9 9 9 9 9 9 9 9 9
9 9 9 9 9 9 9 9 9 9 9 9 9 9 9 9 9 9 9 9
9 9 9 9 9 9 9 9 9 9 9 9 9 9 9 9 9 9 9 9
9 9 9 9 9 9 9 9 9 9 9 9 9 9 9 9 9 9 9 9
9 9 9 9 9 9 9 9 9 9 9 9 9 9 9 9 9 9 9 9
9 9 9 9 9 9 9 0 5 5 5 5 5 5 6 9 9 9 9 9
9 9 9 9 9 9 9 1 4 4 4 4 4 4 1 9 9 9 9 9
9 9 9 0 5 5 5 1 4 8 9 9 2 4 1 5 5 5 6 9
9 9 9 1 4 4 4 4 4 9 9 9 9 4 4 4 4 4 7 9
9 9 9 1 4 4 4 4 4 9 9 9 9 4 4 4 4 4 7 9
9 9 9 2 3 3 3 1 4 6 9 9 0 4 1 3 3 3 8 9
9 9 9 9 9 9 9 1 4 4 4 4 4 4 1 9 9 9 9 9
9 9 9 9 9 9 9 2 3 3 3 3 3 3 8 9 9 9 9 9
9 9 9 9 9 9 9 9 9 9 9 9 9 9 9 9 9 9 9 9
9 9 9 9 9 9 9 9 9 9 9 9 9 9 9 9 9 9 9 9
9 9 9 9 9 9 9 9 9 9 9 9 9 9 9 9 9 9 9 9
9 9 9 9 9 9 9 9 9 9 9 9 9 9 9 9 9 9 9 9
9 9 9 9 9 9 9 9 9 9 9 9 9 9 9 9 9 9 9 9