9 9 9 9 9 9 9 9 9 9 9 9 9 9 9 9 9 9 9 9
9 9 9 9 9 9 9 9 9 9 9 9 9 9 9 9 9 9 9 9
9 9 9 9 9 9 9 9 9 9 9 9 9 9 9 9 9 9 9 9
9 9 9 9 9 9 9 9 9 9 9 9 9 9 9 9 9 9 9 9
9 9 9 9 9 9 9 9 9 9 9 9 9 9 9 9 9 9 9 9
9 9 9 9 9 9 9 9 9 9 9 9 9 9 9 9 9 9 9 9
9 9 9 9 9 9 9 9 9 9 9 9 9 9 9 9 9 9 9 9
9 9 9 9 0 3 3 3 3 3 3 3 6 9 9 9 9 9 9 9
9 9 9 9 1 4 4 4 4 4 4 4 7 9 9 9 9 9 9 9
9 9 9 9 1 4 4 5 5 5 5 5 8 9 9 9 9 9 9 9
9 9 9 9 1 4 7 8 9 9 9 9 9 9 9 9 9 9 9 9
9 9 9 9 1 4 7 9 9 9 9 9 9 9 9 9 9 9 9 9
9 9 9 9 1 4 7 9 9 9 9 9 9 9 9 9 9 9 9 9
9 9 9 9 1 4 7 9 9 9 9 9 9 9 9 9 9 9 9 9
9 9 9 9 1 4 7 9 9 9 9 9 9 9 9 9 9 9 9 9
9 9 9 9 1 4 7 9 9 9 9 9 9 9 9 9 9 9 9 9
9 9 9 9 1 4 7 9 9 9 9 9 9 9 9 9 9 9 9 9
9 9 9 9 2 5 8 9 9 9 9 9 9 9 9 9 9 9 9 9
9 9 9 9 9 9 9 9 9 9 9 9 9 9 9 9 9 9 9 9
9 9 9 9 9 9 9 9 9 9 9 9 9 9 9 9 9 9 9 9